Scenery Init investigation
Scenery End Investigation
Back Yard
You can see a Back Door here.

Scenery Init Murder
Retrospect
An Interactive Fiction by GroopOfFore
Release 1 / Serial number 150404 / Inform 7 build 6L38 (I6/v6.33 lib 6/12N) SD

Back Yard
You can see a Back Door here.

I beg your pardon?

>Current Scene
That's not a verb I recognise.

>scenes
Scene 'Entire Game' playing (for 0 mins now)
Scene 'Investigation' playing (for 0 mins now)
(Scene monitoring now switched on. Type "scenes off" to switch it off again.)

>scener
That's not a verb I recognise.

>scenes
Scene 'Entire Game' playing (for 0 mins now)
Scene 'Investigation' playing (for 0 mins now)
(Scene monitoring now switched on. Type "scenes off" to switch it off again.)

>scenes
Scene 'Entire Game' playing (for 0 mins now)
Scene 'Investigation' playing (for 0 mins now)
(Scene monitoring now switched on. Type "scenes off" to switch it off again.)

>go nroth
You can't see any such thing.

>go north
Living Room

>scenes
Scene 'Entire Game' playing (for 1 mins now)
Scene 'Investigation' playing (for 1 mins now)
(Scene monitoring now switched on. Type "scenes off" to switch it off again.)

>go south
Front Yard
You can see a police officer, some bushes (empty), a garden hose and a mail box (closed) here.

>scenes
Scene 'Entire Game' playing (for 2 mins now)
Scene 'Investigation' playing (for 2 mins now)
(Scene monitoring now switched on. Type "scenes off" to switch it off again.)

>look
Front Yard
You can see a police officer, some bushes (empty), a garden hose and a mail box (closed) here.

>scenes
Scene 'Entire Game' playing (for 3 mins now)
Scene 'Investigation' playing (for 3 mins now)
(Scene monitoring now switched on. Type "scenes off" to switch it off again.)

>say does it look like i give a frickle frackle
(to the police officer)
There is no reply.

* * *

Scenery Init investigation
Scenery End Investigation
Back Yard
You can see a Back Door here.

Scenery Init Murder
Retrospect
An Interactive Fiction by GroopOfFore
Release 1 / Serial number 150404 / Inform 7 build 6L38 (I6/v6.33 lib 6/12N) SD

Back Yard
You can see a Back Door here.

>open mailbox
You open the mail box.

* * *

Scenery Init investigation
Scenery End Investigation
Back Yard
You can see a Back Door here.

Scenery Init Murder
Retrospect
An Interactive Fiction by GroopOfFore
Release 1 / Serial number 150404 / Inform 7 build 6L38 (I6/v6.33 lib 6/12N) SD

Back Yard
You can see a Back Door here.

>examine garden hose
The garden hose has a nozzle attached to it for watering plants.

>look
Front Yard
You can see some surroundings, a police officer, some bushes (empty), a garden hose and a mail box (closed) here.

>scenes
Scene 'Entire Game' playing (for 2 mins now)
Scene 'Investigation' playing (for 2 mins now)
(Scene monitoring now switched on. Type "scenes off" to switch it off again.)

* * *

>look
Front Yard
You can see some surroundings, a police officer, some bushes (empty), a garden hose and a mail box (closed) here.

>take nozzle
You can't see any such thing.

>rules
Rules tracing now switched on. Type "rules off" to switch it off again, or "rules all" to include even rules which do not apply.

>rules
[Rule "declare everything initially unmentioned rule" applies.]
Rules tracing now switched on. Type "rules off" to switch it off again, or "rules all" to include even rules which do not apply.

>open mailboc
[Rule "After deciding the scope of the player" applies.]
[Rule "After deciding the scope of the player" applies.]
You can't see any such thing.

>open mailbox
[Rule "After deciding the scope of the player" applies.]
[Rule "declare everything initially unmentioned rule" applies.]
[Rule "announce items from multiple object lists rule" applies.]
[Rule "set pronouns from items from multiple object lists rule" applies.]
[Rule "before stage rule" applies.]
[Rule "instead stage rule" applies.]
[Rule "investigate player's awareness before action rule" applies.]
[Rule "player aware of his own actions rule" applies.]
[Rule "check stage rule" applies.]
[Rule "can't open unless openable rule" applies.]
[Rule "can't open what's locked rule" applies.]
[Rule "can't open what's already open rule" applies.]
[Rule "carry out stage rule" applies.]
[Rule "standard opening rule" applies.]
[Rule "after stage rule" applies.]
[Rule "investigate player's awareness after action rule" applies.]
[Rule "report stage rule" applies.]
[Rule "reveal any newly visible interior rule" applies.]
[Rule "standard report opening rule" applies.]
You open the mail box.
[Rule "last specific action-processing rule" applies.]

[Rule "A first turn sequence rule" applies.]
[Rule "every turn stage rule" applies.]
[Rule "A last turn sequence rule" applies.]
[Rule "notify score changes rule" applies.]

>take nozzl
[Rule "After deciding the scope of the player" applies.]
[Rule "After deciding the scope of the player" applies.]
[Rule "After deciding the scope of the player" applies.]
You can't see any such thing.

>take nozzle
[Rule "After deciding the scope of the player" applies.]
[Rule "After deciding the scope of the player" applies.]
[Rule "After deciding the scope of the player" applies.]
You can't see any such thing.

>examine mail box
[Rule "After deciding the scope of the player" applies.]
[Rule "declare everything initially unmentioned rule" applies.]
[Rule "announce items from multiple object lists rule" applies.]
[Rule "set pronouns from items from multiple object lists rule" applies.]
[Rule "before stage rule" applies.]
[Rule "can't act in the dark rule" applies.]
[Rule "instead stage rule" applies.]
[Rule "investigate player's awareness before action rule" applies.]
[Rule "player aware of his own actions rule" applies.]
[Rule "check stage rule" applies.]
[Rule "carry out stage rule" applies.]
[Rule "standard examining rule" applies.]
The house number 606 is on its side. The mail box is empty.

[Rule "examine directions rule" applies.]
[Rule "examine containers rule" applies.]
[Rule "examine supporters rule" applies.]
[Rule "examine devices rule" applies.]
[Rule "examine undescribed things rule" applies.]
[Rule "after stage rule" applies.]
[Rule "investigate player's awareness after action rule" applies.]
[Rule "report stage rule" applies.]
[Rule "report other people examining rule" applies.]
[Rule "last specific action-processing rule" applies.]
[Rule "A first turn sequence rule" applies.]
[Rule "every turn stage rule" applies.]
[Rule "A last turn sequence rule" applies.]
[Rule "notify score changes rule" applies.]

>close mailbox
[Rule "After deciding the scope of the player" applies.]
[Rule "declare everything initially unmentioned rule" applies.]
[Rule "announce items from multiple object lists rule" applies.]
[Rule "set pronouns from items from multiple object lists rule" applies.]
[Rule "before stage rule" applies.]
[Rule "instead stage rule" applies.]
[Rule "investigate player's awareness before action rule" applies.]
[Rule "player aware of his own actions rule" applies.]
[Rule "check stage rule" applies.]
[Rule "can't close unless openable rule" applies.]
[Rule "can't close what's already closed rule" applies.]
[Rule "carry out stage rule" applies.]
[Rule "standard closing rule" applies.]
[Rule "after stage rule" applies.]
[Rule "investigate player's awareness after action rule" applies.]
[Rule "report stage rule" applies.]
[Rule "standard report closing rule" applies.]
You close the mail box.
[Rule "last specific action-processing rule" applies.]

[Rule "A first turn sequence rule" applies.]
[Rule "every turn stage rule" applies.]
[Rule "A last turn sequence rule" applies.]
[Rule "notify score changes rule" applies.]

>examine mail box
[Rule "After deciding the scope of the player" applies.]
[Rule "declare everything initially unmentioned rule" applies.]
[Rule "announce items from multiple object lists rule" applies.]
[Rule "set pronouns from items from multiple object lists rule" applies.]
[Rule "before stage rule" applies.]
[Rule "can't act in the dark rule" applies.]
[Rule "instead stage rule" applies.]
[Rule "investigate player's awareness before action rule" applies.]
[Rule "player aware of his own actions rule" applies.]
[Rule "check stage rule" applies.]
[Rule "carry out stage rule" applies.]
[Rule "standard examining rule" applies.]
The house number 606 is on its side.

[Rule "examine directions rule" applies.]
[Rule "examine containers rule" applies.]
[Rule "examine supporters rule" applies.]
[Rule "examine devices rule" applies.]
[Rule "examine undescribed things rule" applies.]
[Rule "after stage rule" applies.]
[Rule "investigate player's awareness after action rule" applies.]
[Rule "report stage rule" applies.]
[Rule "report other people examining rule" applies.]
[Rule "last specific action-processing rule" applies.]
[Rule "A first turn sequence rule" applies.]
[Rule "every turn stage rule" applies.]
[Rule "A last turn sequence rule" applies.]
[Rule "notify score changes rule" applies.]

* * *

>look
Front Yard
You can see some surroundings, a police officer, some bushes (empty), a garden hose and a mail box (closed) here.

>take nozzl
You can't see any such thing.

>take nozzle
You can't see any such thing.

* * *

Scenery Init investigation
Scenery End Investigation
Back Yard
You can see a Back Door here.

Scenery Init Murder
Retrospect
An Interactive Fiction by GroopOfFore
Release 1 / Serial number 150404 / Inform 7 build 6L38 (I6/v6.33 lib 6/12N) SD

Back Yard
You can see a Back Door here.

>examien garden hose
That's not a verb I recognise.

>examine garden hose
The garden hose has a nozzle attached to it for watering plants.

>look
Front Yard
You can see some surroundings, a police officer, some bushes (empty), a garden hose and a mail box (empty) here.

>scenes
Scene 'Entire Game' playing (for 2 mins now)
(Scene monitoring now switched on. Type "scenes off" to switch it off again.)

>take nozzle
Taken.

>examine mail box
The mail box is empty.

* * *

>look
Front Yard
You can see some surroundings, a police officer, some bushes (empty), a garden hose and a mail box (empty) here.

>take nozzle
You can't see any such thing.

>look
Front Yard
You can see some surroundings, a police officer, some bushes (empty), a garden hose and a mail box (empty) here.

>examine garden hose
The garden hose has a nozzle attached to it for watering plants.

* * *

>look
Front Yard
You can see some surroundings, a police officer, some bushes (empty), a garden hose and a mail box (empty) here.

>rulebook
That's not a verb I recognise.

>rulesbook
That's not a verb I recognise.

>rules
Rules tracing now switched on. Type "rules off" to switch it off again, or "rules all" to include even rules which do not apply.

* * *

Scenery Init investigation
Scenery End Investigation
Back Yard
You can see a Back Door here.

Scenery Init Murder
Retrospect
An Interactive Fiction by GroopOfFore
Release 1 / Serial number 150404 / Inform 7 build 6L38 (I6/v6.33 lib 6/12N) SD

Back Yard
You can see a Back Door here.

>examine mail box
The house number 606 is on its side.

* * *

Scenery Init investigation
Scenery End Investigation
Back Yard
You can see a Back Door here.

Scenery Init Murder
Retrospect
An Interactive Fiction by GroopOfFore
Release 1 / Serial number 150404 / Inform 7 build 6L38 (I6/v6.33 lib 6/12N) SD

Back Yard
You can see a Back Door here.

>open mail box
It isn't something you can open.

>look
Front Yard
You can see some surroundings, a police officer, some bushes (empty), a garden hose and a mail box (empty) here.

>examien garden hose
That's not a verb I recognise.

* * *

>examine garden hose
The garden hose has a nozzle attached to it for watering plants.

>look
Front Yard
You can see a nozzle, some surroundings, a police officer, some bushes (empty), a garden hose and a mail box (empty) here.

* * *

Scenery Init investigation
Scenery End Investigation
Back Yard
You can see a Back Door here.

Scenery Init Murder
Retrospect
An Interactive Fiction by GroopOfFore
Release 1 / Serial number 150404 / Inform 7 build 6L38 (I6/v6.33 lib 6/12N) SD

Back Yard
You can see a Back Door here.

>rules
Rules tracing now switched on. Type "rules off" to switch it off again, or "rules all" to include even rules which do not apply.

* * *

>examine garden hose
[Rule "After deciding the scope of the player" applies.]
[Rule "declare everything initially unmentioned rule" applies.]
[Rule "announce items from multiple object lists rule" applies.]
[Rule "set pronouns from items from multiple object lists rule" applies.]
[Rule "before stage rule" applies.]
[Rule "can't act in the dark rule" applies.]
[Rule "instead stage rule" applies.]
[Rule "investigate player's awareness before action rule" applies.]
[Rule "player aware of his own actions rule" applies.]
[Rule "check stage rule" applies.]
[Rule "carry out stage rule" applies.]
[Rule "standard examining rule" applies.]
The garden hose has a nozzle attached to it for watering plants.

[Rule "examine directions rule" applies.]
[Rule "examine containers rule" applies.]
[Rule "examine supporters rule" applies.]
[Rule "examine devices rule" applies.]
[Rule "examine undescribed things rule" applies.]
[Rule "after stage rule" applies.]
[Rule "investigate player's awareness after action rule" applies.]
[Rule "report stage rule" applies.]
[Rule "report other people examining rule" applies.]
[Rule "last specific action-processing rule" applies.]
[Rule "A first turn sequence rule" applies.]
[Rule "every turn stage rule" applies.]
[Rule "A last turn sequence rule" applies.]
[Rule "notify score changes rule" applies.]

* * *

>examine bushes
[Rule "After deciding the scope of the player" applies.]
[Rule "declare everything initially unmentioned rule" applies.]
[Rule "announce items from multiple object lists rule" applies.]
[Rule "set pronouns from items from multiple object lists rule" applies.]
[Rule "before stage rule" applies.]
[Rule "can't act in the dark rule" applies.]
[Rule "instead stage rule" applies.]
[Rule "investigate player's awareness before action rule" applies.]
[Rule "player aware of his own actions rule" applies.]
[Rule "check stage rule" applies.]
[Rule "carry out stage rule" applies.]
[Rule "standard examining rule" applies.]
The bushes have beautiful white flowers on them, but they could use some water.

[Rule "examine directions rule" applies.]
[Rule "examine containers rule" applies.]
[Rule "examine supporters rule" applies.]
[Rule "examine devices rule" applies.]
[Rule "examine undescribed things rule" applies.]
[Rule "after stage rule" applies.]
[Rule "investigate player's awareness after action rule" applies.]
[Rule "report stage rule" applies.]
[Rule "report other people examining rule" applies.]
[Rule "last specific action-processing rule" applies.]
[Rule "A first turn sequence rule" applies.]
[Rule "every turn stage rule" applies.]
[Rule "A last turn sequence rule" applies.]
[Rule "notify score changes rule" applies.]

* * *

>rules
[Rule "declare everything initially unmentioned rule" applies.]
Rules tracing now switched on. Type "rules off" to switch it off again, or "rules all" to include even rules which do not apply.

>open mailbox
[Rule "After deciding the scope of the player" applies.]
[Rule "declare everything initially unmentioned rule" applies.]
[Rule "announce items from multiple object lists rule" applies.]
[Rule "set pronouns from items from multiple object lists rule" applies.]
[Rule "before stage rule" applies.]
[Rule "instead stage rule" applies.]
[Rule "investigate player's awareness before action rule" applies.]
[Rule "player aware of his own actions rule" applies.]
[Rule "check stage rule" applies.]
[Rule "can't open unless openable rule" applies.]
[Rule "can't open what's locked rule" applies.]
[Rule "can't open what's already open rule" applies.]
[Rule "carry out stage rule" applies.]
[Rule "standard opening rule" applies.]
[Rule "after stage rule" applies.]
[Rule "investigate player's awareness after action rule" applies.]
[Rule "report stage rule" applies.]
[Rule "reveal any newly visible interior rule" applies.]
[Rule "standard report opening rule" applies.]
You open the mail box.
[Rule "last specific action-processing rule" applies.]

[Rule "A first turn sequence rule" applies.]
[Rule "every turn stage rule" applies.]
[Rule "A last turn sequence rule" applies.]
[Rule "notify score changes rule" applies.]

>examine garden hose
[Rule "After deciding the scope of the player" applies.]
[Rule "declare everything initially unmentioned rule" applies.]
[Rule "announce items from multiple object lists rule" applies.]
[Rule "set pronouns from items from multiple object lists rule" applies.]
[Rule "before stage rule" applies.]
[Rule "can't act in the dark rule" applies.]
[Rule "instead stage rule" applies.]
[Rule "investigate player's awareness before action rule" applies.]
[Rule "player aware of his own actions rule" applies.]
[Rule "check stage rule" applies.]
[Rule "carry out stage rule" applies.]
[Rule "standard examining rule" applies.]
The garden hose has a nozzle attached to it for watering plants.

[Rule "examine directions rule" applies.]
[Rule "examine containers rule" applies.]
[Rule "examine supporters rule" applies.]
[Rule "examine devices rule" applies.]
[Rule "examine undescribed things rule" applies.]
[Rule "after stage rule" applies.]
[Rule "investigate player's awareness after action rule" applies.]
[Rule "report stage rule" applies.]
[Rule "report other people examining rule" applies.]
[Rule "last specific action-processing rule" applies.]
[Rule "A first turn sequence rule" applies.]
[Rule "every turn stage rule" applies.]
[Rule "A last turn sequence rule" applies.]
[Rule "notify score changes rule" applies.]

* * *

>rules off
[Rule "declare everything initially unmentioned rule" applies.]
Rules tracing now switched off. Type "rules" to switch it on again.

>look
Front Yard
You can see some surroundings, a police officer, some bushes (empty), a garden hose and a mail box (empty) here.

* * *

Scenery Init investigation
Scenery End Investigation
Back Yard
You can see a Back Door here.

Scenery Init Murder
Retrospect
An Interactive Fiction by GroopOfFore
Release 1 / Serial number 150404 / Inform 7 build 6L38 (I6/v6.33 lib 6/12N) SD

Back Yard
You can see a Back Door here.

>examien garden hsoe
That's not a verb I recognise.

>examine garden hose
The garden hose has a nozzle attached to it for watering plants.

>look
Front Yard
You can see a nozzle, some surroundings, a police officer, some bushes (empty), a garden hose and a mail box (closed) here.

* * *

Scenery Init investigation
Scenery End Investigation
Back Yard
You can see a Back Door here.

Scenery Init Murder
Retrospect
An Interactive Fiction by GroopOfFore
Release 1 / Serial number 150404 / Inform 7 build 6L38 (I6/v6.33 lib 6/12N) SD

Back Yard
You can see a Back Door here.

>water bushes
You have nothing with which to water the plant.

* * *

Scenery Init investigation
Scenery End Investigation
Back Yard
You can see a Back Door here.

Scenery Init Murder
Retrospect
An Interactive Fiction by GroopOfFore
Release 1 / Serial number 150404 / Inform 7 build 6L38 (I6/v6.33 lib 6/12N) SD

Back Yard
You can see a Back Door here.

>look
Back Yard

>go south
Kitchen
You can see a microwave (in which is a ham sammich), a refrigerator (in which is milk), an oven (in which is an applie pie), a spilled cup and a dark stain here.

>go up
Upstairs

* * *

>go west
You can't go that way.

>go south
Child's Bedroom

>look
Child's Bedroom

* * *

Scenery Init investigation
Scenery End Investigation
Back Yard
You can see a Back Door here.

Scenery Init Murder
Retrospect
An Interactive Fiction by GroopOfFore
Release 1 / Serial number 150404 / Inform 7 build 6L38 (I6/v6.33 lib 6/12N) SD

Back Yard
You can see a Back Door here.

>go south
(first opening the Back Door)
It seems to be locked.

>go up
Upstairs

>go south
Child's Bedroom
You can see a child's bed, an alarm clock and a bookshelf here.

>look
Child's Bedroom

* * *

>go south
Child's Bedroom
You can see a child's bed, an alarm clock and a bookshelf here.

>examine bed
The child's bed looks normal.

>smell bed
You smell nothing unexpected.

* * *

>go south
Child's Bedroom
You can see a child's bed, an alarm clock and a bookshelf here.

>smell the bed
You smell nothing unexpected.

* * *

>go south
Child's Bedroom
You can see a child's bed, an alarm clock and a bookshelf here.

>smell bed
It smells faintly of urine.

* * *

>go south
Child's Bedroom
You can see a child's bed, an alarm clock and a bookshelf here.

>examine child's bed
The child's bed looks normal.

>smell child's be
I only understood you as far as wanting to smell the child's bed.

>smell child's bed
It smells faintly of urine.

>examine alarm clock
An ordinary alarm clock. It's set to go off at 7:10 am.

>examine booksheld
You can't see any such thing.

>examine bookshelf
A wooden bookshelf. It has the Hunger Games and Percy Jackson series neatly aligned on its third shelf. The other shelves are filled with Star Wars legos and photos.

>look
Child's Bedroom
You can see a family photo, some surroundings, a child's bed, an alarm clock and a bookshelf here.

>examine family photo
A family of four. An infant daughter is on the far left next to her mother. The father is on the far right and has placed his arm on his son's knee. The son is sitting cross-legged evenly between his mother and his father. Nobody seems thrilled to be in the photo.

* * *

>go south
Child's Bedroom
You can see a child's bed, an alarm clock and a bookshelf here.

>examine bookshelf
A wooden bookshelf. It has the Hunger Games and Percy Jackson series neatly aligned on its third shelf. The other shelves are filled with Star Wars Legos and photos.

>look
Child's Bedroom
You can see a family photo, some surroundings, a child's bed, an alarm clock and a bookshelf here.

* * *

>go south
(first opening the Back Door)
It seems to be locked.

>look
Back Yard
You can see some surroundings and a Back Door here.

* * *

>go south
(first opening the Back Door)
It seems to be locked.

>unlock Back Door
What do you want to unlock the Back Door with?

* * *

>go south
(first opening the Back Door)
It seems to be locked.

>pick the pack door
You can't see any such thing.

>pick the door
Picking... (press random keys)

* * *

>go south
(first opening the Back Door)
It seems to be locked.

>pick back door
Picking... (press random keys)

*clank*

*click*

*clank*

*clank*

* * *

*click*

*click*

* * *

>go south
(first opening the Back Door)
It seems to be locked.

>pick door
Picking... (press random keys)

*click*
Done.

>go south
(first opening the Back Door)

Kitchen
You can see a Back Door, a microwave (in which is a ham sammich), a refrigerator (in which is milk), an oven (in which is an applie pie), a spilled cup and a dark stain here.

>go north
Back Yard
You can see a Back Door here.

>pick door
Picking... (press random keys)

*clank*

*clank*
Done.

I beg your pardon?

* * *

Scenery Init investigation
Scenery End Investigation
Back Yard
You can see a Back Door here.

Scenery Init Murder
Retrospect
An Interactive Fiction by GroopOfFore
Release 1 / Serial number 150404 / Inform 7 build 6L38 (I6/v6.33 lib 6/12N) SD

Back Yard
You can see a Back Door here.

>inventory
You are carrying:
  a pick gun

>unlock back door
(with the pick gun)
That doesn't seem to be something you can unlock.

>go south
(first opening the Back Door)
It seems to be locked.

* * *

>go south
(first opening the Back Door)
It seems to be locked.

* * *

Scenery Init investigation
Scenery End Investigation
Back Yard
You can see a Back Door here.

Scenery Init Murder
Retrospect
An Interactive Fiction by GroopOfFore
Release 1 / Serial number 150404 / Inform 7 build 6L38 (I6/v6.33 lib 6/12N) SD

Back Yard
You can see a Back Door here.

>pick the back door
Picking...

Done.

>go south
(first opening the Back Door)

Kitchen
You can see a Back Door, a microwave (in which is a ham sammich), a refrigerator (in which is milk), an oven (in which is an applie pie), a spilled cup and a dark stain here.

* * *

Scenery Init investigation
Scenery End Investigation
Back Yard
You can see a Back Door here.

Scenery Init Murder
Retrospect
An Interactive Fiction by GroopOfFore
Release 1 / Serial number 150404 / Inform 7 build 6L38 (I6/v6.33 lib 6/12N) SD

Back Yard
You can see a Back Door here.

>pick back door
Picking...

* * *

Scenery Init investigation
Scenery End Investigation
Back Yard
You can see a Back Door here.

Scenery Init Murder
Retrospect
An Interactive Fiction by GroopOfFore
Release 1 / Serial number 150404 / Inform 7 build 6L38 (I6/v6.33 lib 6/12N) SD

Back Yard
You can see a Back Door here.

>pick door
Picking... (press random keys)

* * *

*clank*

I beg your pardon?

* * *

*click*

>pick door
Picking... (press random keys)

*click*

* * *

I beg your pardon?

>go south
(first opening the Back Door)
It seems to be locked.