Scenery Init investigation
Retrospect
An Interactive Fiction by GroopOfFore
Release 1 / Serial number 150404 / Inform 7 build 6L38 (I6/v6.33 lib 6/12N) SD

Front Yard
You can see a front door, a police officer, some bushes (empty), a garden hose and a mail box (closed) here.

>poop
This is not the time to do that.

>adsf
That's not a verb I recognise.

* * *

Scenery Init investigation
Retrospect
An Interactive Fiction by GroopOfFore
Release 1 / Serial number 150404 / Inform 7 build 6L38 (I6/v6.33 lib 6/12N) SD

Front Yard
You can see a front door, a police officer, some bushes (empty), a garden hose and a mail box (closed) here.

>fly
You wish.

>clear
What do you want to clear?

>transcript
Attempt to begin transcript failed.

>cls
That's not a verb I recognise.

>clear screen
You can't see any such thing.

* * *

Scenery Init investigation
Retrospect
An Interactive Fiction by GroopOfFore
Release 1 / Serial number 150404 / Inform 7 build 6L38 (I6/v6.33 lib 6/12N) SD

Front Yard
You can see a front door, a police officer, some bushes (empty), a garden hose and a mail box (closed) here.

>be
You must supply a noun.

>be awesome
I only understood you as far as wanting to be.

>look behind bush
You can't see any such thing.

>look behind bushes
You can't see any such thing.

>look under bushes
You find nothing of interest.

>look above bushes
You can't see any such thing.

>enter bushes
Ow, that hurt. At least I'm in a bush now.

* * *

Scenery Init investigation
Retrospect
An Interactive Fiction by GroopOfFore
Release 1 / Serial number 150404 / Inform 7 build 6L38 (I6/v6.33 lib 6/12N) SD

Front Yard
You can see a front door, a police officer, some bushes (empty), a garden hose and a mail box (closed) here.

>take door
That's fixed in place.

>take bushes
That's fixed in place.

* * *

Scenery Init investigation
Retrospect
An Interactive Fiction by GroopOfFore
Release 1 / Serial number 150404 / Inform 7 build 6L38 (I6/v6.33 lib 6/12N) SD

Front Yard
You can see a front door, a police officer, some bushes (empty), a garden hose and a mail box (closed) here.

>talk to police
You'd better keep looking for clues instead of talking to me or the chief is gonna get pissed.

* * *

Scenery Init investigation
Retrospect
An Interactive Fiction by GroopOfFore
Release 1 / Serial number 150404 / Inform 7 build 6L38 (I6/v6.33 lib 6/12N) SD

Front Yard
You can see a front door, a police officer, some bushes (empty), a garden hose and a mail box (closed) here.

>drop your phone
You can't see any such thing.

>drop phone
You won't risk that until you've bought a case for it.

>n
(first opening the front door)

Living Room
You can see a front door, a couch and a TV here.

>n
Kitchen
You can see a back door, a microwave (in which is a ham sammich), a refrigerator (in which is milk), an oven (in which is an apple pie), a spilled cup, a dark stain and a beer cabinet (empty) here.

>u
Upstairs

>e
Master Bedroom
You can see a desk (closed) and a guy here.

>open desk
You open the desk, revealing a cell phone.

>take phone
(the cell phone)
Taken.

>x your phone
You can't see any such thing.

>drop phone
Which do you mean, the cell phone or your phone?

>drop cell phone
Dropped.

>drop your phone
You can't see any such thing.

>d
You can't go that way.

>w
Upstairs

>d
Kitchen
You can see a back door, a microwave (in which is a ham sammich), a refrigerator (in which is milk), an oven (in which is an apple pie), a spilled cup, a dark stain and a beer cabinet (empty) here.

>eat all
You can't use multiple objects with that verb.

>eat sammich and milk
You can't use multiple objects with that verb.

>eat sammich
(first taking the ham sammich)
Maybe that was a bad idea. This is a crime scene, not a buffet.

>eat pie
(first taking the apple pie)
Maybe that was a bad idea. But a delicious one.

>take stain
Do you even know how stains work?

>score
You have so far scored 0 out of a possible 20, in 15 turns.

>save
Save failed.

>restore
Restore failed.

* * *

Scenery Init investigation
Retrospect
An Interactive Fiction by GroopOfFore
Release 1 / Serial number 150404 / Inform 7 build 6L38 (I6/v6.33 lib 6/12N) SD

Front Yard
You can see a front door, a police officer, some bushes (empty), a garden hose and a mail box (closed) here.

>x bush
The bushes have beautiful white flowers on them, but they could use some water.

>x hose
The garden hose has a nozzle attached to it for watering plants.

>take box
That's fixed in place.

>x box
The house number 606 is on its side.

* * *

Scenery Init investigation
Retrospect
An Interactive Fiction by GroopOfFore
Release 1 / Serial number 150404 / Inform 7 build 6L38 (I6/v6.33 lib 6/12N) SD

Front Yard
You can see a front door, a police officer, some bushes (empty), a garden hose and a mail box (closed) here.

>take police
I don't suppose the police officer would care for that.

>i
You are carrying:
  your phone
  your clothes

>ls
You are carrying:
  your phone
  your clothes

>dir
You are carrying:
  your phone
  your clothes

>i
You are carrying:
  your phone
  your clothes

>inventory
You are carrying:
  your phone
  your clothes

* * *

Scenery Init investigation
Retrospect
An Interactive Fiction by GroopOfFore
Release 1 / Serial number 150404 / Inform 7 build 6L38 (I6/v6.33 lib 6/12N) SD

Front Yard
You can see a front door, a police officer, some bushes (empty), a garden hose and a mail box (closed) here.

>score
You have so far scored 0 out of a possible 20, in 1 turn.

>n
(first opening the front door)

Living Room
You can see a front door, a couch and a TV here.

* * *

>open desk
You open the desk, revealing a cell phone.

>x phone
(your phone)
You see nothing special about your phone.

>x cell phone
There appear to be the contacts of various drug dealers here.

>score
You have so far scored 0 out of a possible 20, in 8 turns.

>e
You can't go that way.

[Your score has just gone up by one point.]

>w
Upstairs

* * *

Scenery Init investigation
Retrospect
An Interactive Fiction by GroopOfFore
Release 1 / Serial number 150404 / Inform 7 build 6L38 (I6/v6.33 lib 6/12N) SD

Front Yard
You can see a front door, a police officer, some bushes (empty), a garden hose and a mail box (closed) here.

>n
(first opening the front door)

Living Room
You can see a front door, a couch and a TV here.

* * *

>e
Master Bedroom
You can see a desk (closed) and a guy here.

>x phone
You see nothing special about your phone.

>open desk
It isn't something you can open.

* * *

>open desk
You open the desk, revealing a cell phone.

>take phone
(the cell phone)
You can't take evidence from the scene of the crime

>x phone
Which do you mean, the cell phone or your phone?

>your
You can't see any such thing.

>x phone
Which do you mean, the cell phone or your phone?

>your phone
You can't see any such thing.

>i
You are carrying:
  a cell phone
  your phone
  your clothes

>x your phone
You can't see any such thing.

>drop your phone
You can't see any such thing.

>drop phone
Which do you mean, the cell phone or your phone?

>drop your phone
You can't see any such thing.

* * *

>n
Kitchen
You can see a back door, a microwave (in which is a ham sammich), a refrigerator (in which is milk), an oven (in which is an apple pie), a spilled cup, a dark stain and a beer cabinet (empty) here.

>eat pie
(first taking the apple pie)
Maybe that was a bad idea. But a delicious one.

* * *

>n
Kitchen
You can see a back door, a microwave (in which is a ham sammich), a refrigerator (in which is milk), an oven (in which is an apple pie), a spilled cup, a dark stain and a beer cabinet (empty) here.

>look under fridge
You see a card here.

>look under fridge
You find nothing of interest.

>eat fridge
That's plainly inedible.

>take fridge
That's fixed in place.

>take microwave
Taken.

* * *

>look under fridge
You see a card here.

>take card
You can't take evidence from the scene of the crime

>pwd
Kitchen
You can see some surroundings, a card, a back door, a microwave (in which is a ham sammich), a refrigerator (in which is milk), an oven (in which is an apple pie), a spilled cup, a dark stain and a beer cabinet (empty) here.

>x card
You see nothing special about the card.

>poop
That's not a verb I recognise.

* * *

>n
Kitchen
You can see a back door, a microwave (in which is a ham sammich), a refrigerator (in which is milk), an oven (in which is an apple pie), a spilled cup, a dark stain and a beer cabinet (empty) here.

>x cup
Smells of alcohol.

>x self
As good-looking as ever.

>break self
Violence isn't the answer to this one.

>break all
You can't use multiple objects with that verb.

>eat all
You can't use multiple objects with that verb.

>be phone
That's not a verb I recognise.

* * *

Scenery Init investigation
Retrospect
An Interactive Fiction by GroopOfFore
Release 1 / Serial number 150404 / Inform 7 build 6L38 (I6/v6.33 lib 6/12N) SD

Front Yard
You can see a front door, a police officer, some bushes (empty), a garden hose and a mail box (closed) here.

>enter bushes
Ow, that hurt. At least I'm in a bush now.

>out
You get out of the bushes.

Front Yard
You can see some surroundings, a front door, a police officer, some bushes (empty), a garden hose and a mail box (closed) here.

>in
You can't go that way.

>in bush
I only understood you as far as wanting to (go) in.

>in bushes
I only understood you as far as wanting to (go) in.