Scenery Init investigation
Retrospect
An Interactive Fiction by GroopOfFore
Release 1 / Serial number 150411 / Inform 7 build 6L38 (I6/v6.33 lib 6/12N) SD

Front Yard
You can see a front door, a police officer, some bushes (empty), a garden hose and a mail box (closed) here.

>go north
(first opening the front door)

Living Room
You can see a front door, a couch, a TV and a laptop here.

>examine surroundings
Living Room description

>look at TV
An old television. It doesn't seem to be working

[Your score has just gone up by one point.]

>look at the couch
Just a couch

[Your score has just gone up by one point.]

>look at Television
An old television. It doesn't seem to be working

[Your score has just gone up by one point.]

* * *

>go north
(first opening the front door)

Living Room
You can see a front door, a couch, a TV and a laptop here.

>go east
Garage
You can see a car (empty), a tool bench (in which are a wrench, a screwdriver, a hand drill and a hammer) and a power box here.

>examine power box
It provides electricity to the house. It seems to have been smashed by something

* * *

>go east
Garage
You can see a car (empty), a tool bench (in which are a wrench, a screwdriver, a hand drill and a hammer) and a power box here.

>break power box
Violence isn't the answer to this one.

>destroy power box
Violence isn't the answer to this one.

>destroy the power box
Violence isn't the answer to this one.

* * *

>break power box
Violence isn't the answer to this one.

>current scene
That's not a verb I recognise.

>break the power box
Violence isn't the answer to this one.

* * *

>go east
Garage
You can see a car (empty), a tool bench (in which are a wrench, a screwdriver, a hand drill and a hammer) and a power box here.

>go east
You can't go that way.

>destroy power box
Violence isn't the answer to this one.

>break power box
Violence isn't the answer to this one.

* * *

>go north
(first opening the front door)

Living Room
You can see a front door, a couch, a TV and a laptop here.

>examine couch
Just a couch

[Your score has just gone up by one point.]

>look under couch
You find a large bag of Ketamine. You pull it out from underneath the couch

>look under couch
You find nothing of interest.

>take ketamine
You can't take evidence from the scene of the crime

>look at sofa
Just a couch

[Your score has just gone up by one point.]

>examine surroundings
Living Room description

>look around
You can't see any such thing.

>inv
You are carrying:
  your phone
  your clothes

>dir
You are carrying:
  your phone
  your clothes

>use phone
That's not a verb I recognise.

>take off clothes
You aren't wearing your clothes.

>burn clothes
This dangerous act would achieve little.

>cd
You'll have to say which compass direction to go in.

>go
You'll have to say which compass direction to go in.

>go east
Garage
You can see a car (empty), a tool bench (in which are a wrench, a screwdriver, a hand drill and a hammer) and a power box here.

>look at hand drill
A common household tool... or possibly a brutal weapon

>take hand drill
You can't take evidence from the scene of the crime

>take powerbox
You can't see any such thing.

>take power box
That's fixed in place.

>look at power box
It provides electricity to the house. It seems to have been smashed by something

>look behind power box
You can't see any such thing.

>look under power box
You find nothing of interest.

>look above power box
You can't see any such thing.

>look below power box
You can't see any such thing.

>go west
Living Room
You can see a Ketamine, a front door, a couch, a TV and a laptop here.

>burn door
This dangerous act would achieve little.

>kiss couch
You can only do that to something animate.

>look at laptop
A modest HP Laptop.  Try switching it on. 

[Your score has just gone up by one point.]

>turn on laptop
The laptop is now turned on.

I beg your pardon?

>look at laptop
A modest HP Laptop.  The Laptop is locked. You will need to find the password. Don't waste your time guessing. 

[Your score has just gone up by one point.]

>go north
Kitchen
You can see a back door, a microwave (in which is a ham sammich), a card, a refrigerator (in which is milk), an oven (in which is an apple pie), a spilled cup, a dark stain and a beer cabinet (empty) here.

>look at beer cabinet
The beer cabinet is empty.

>examine surroundings
Kitchen description

>take microwave
That's fixed in place.

>look at card
This is evidence.

[Your score has just gone up by one point.]

* * *

>help
> Introduction to Retrospect
   Instructions for Play

>n
Introduction to Retrospect
 > Instructions for Play

   Introduction to Retrospect
 > Instructions for Play

>[enter]
> About Interactive Fiction
   What to do with >
   Getting Started
   Rooms and Travel
   Objects
   Controlling the Game
   How the World is Assembled
   If You Get Stuck

>n
About Interactive Fiction
 > What to do with >
   Getting Started
   Rooms and Travel
   Objects
   Controlling the Game
   How the World is Assembled
   If You Get Stuck

   About Interactive Fiction
 > What to do with >
   Getting Started
   Rooms and Travel
   Objects
   Controlling the Game
   How the World is Assembled
   If You Get Stuck

>[enter]
The > sign is where the game says, "Okay, what do you want to do now?"  You may respond by typing an instruction -- usually an imperative verb, possibly followed by prepositions and objects.  So, for instance, LOOK, LOOK AT FISH, TAKE FISH.

Please press SPACE to continue.

* * *

About Interactive Fiction
 > What to do with >
   Getting Started
   Rooms and Travel
   Objects
   Controlling the Game
   How the World is Assembled
   If You Get Stuck

   About Interactive Fiction
 > What to do with >
   Getting Started
   Rooms and Travel
   Objects
   Controlling the Game
   How the World is Assembled
   If You Get Stuck

>[back]
About Interactive Fiction
 > What to do with >
   Getting Started
   Rooms and Travel
   Objects
   Controlling the Game
   How the World is Assembled
   If You Get Stuck

>[down]
About Interactive Fiction
   What to do with >
 > Getting Started
   Rooms and Travel
   Objects
   Controlling the Game
   How the World is Assembled
   If You Get Stuck

   About Interactive Fiction
   What to do with >
 > Getting Started
   Rooms and Travel
   Objects
   Controlling the Game
   How the World is Assembled
   If You Get Stuck

>[down]
About Interactive Fiction
   What to do with >
   Getting Started
 > Rooms and Travel
   Objects
   Controlling the Game
   How the World is Assembled
   If You Get Stuck

   About Interactive Fiction
   What to do with >
   Getting Started
 > Rooms and Travel
   Objects
   Controlling the Game
   How the World is Assembled
   If You Get Stuck

>[down]
About Interactive Fiction
   What to do with >
   Getting Started
   Rooms and Travel
 > Objects
   Controlling the Game
   How the World is Assembled
   If You Get Stuck

   About Interactive Fiction
   What to do with >
   Getting Started
   Rooms and Travel
 > Objects
   Controlling the Game
   How the World is Assembled
   If You Get Stuck

>[down]
About Interactive Fiction
   What to do with >
   Getting Started
   Rooms and Travel
   Objects
 > Controlling the Game
   How the World is Assembled
   If You Get Stuck

   About Interactive Fiction
   What to do with >
   Getting Started
   Rooms and Travel
   Objects
 > Controlling the Game
   How the World is Assembled
   If You Get Stuck

>[down]
About Interactive Fiction
   What to do with >
   Getting Started
   Rooms and Travel
   Objects
   Controlling the Game
 > How the World is Assembled
   If You Get Stuck

   About Interactive Fiction
   What to do with >
   Getting Started
   Rooms and Travel
   Objects
   Controlling the Game
 > How the World is Assembled
   If You Get Stuck

>[down]
About Interactive Fiction
   What to do with >
   Getting Started
   Rooms and Travel
   Objects
   Controlling the Game
   How the World is Assembled
 > If You Get Stuck

   About Interactive Fiction
   What to do with >
   Getting Started
   Rooms and Travel
   Objects
   Controlling the Game
   How the World is Assembled
 > If You Get Stuck

>[up]
About Interactive Fiction
   What to do with >
   Getting Started
   Rooms and Travel
   Objects
   Controlling the Game
 > How the World is Assembled
   If You Get Stuck

   About Interactive Fiction
   What to do with >
   Getting Started
   Rooms and Travel
   Objects
   Controlling the Game
 > How the World is Assembled
   If You Get Stuck

>[up]
About Interactive Fiction
   What to do with >
   Getting Started
   Rooms and Travel
   Objects
 > Controlling the Game
   How the World is Assembled
   If You Get Stuck

   About Interactive Fiction
   What to do with >
   Getting Started
   Rooms and Travel
   Objects
 > Controlling the Game
   How the World is Assembled
   If You Get Stuck

>[down]
About Interactive Fiction
   What to do with >
   Getting Started
   Rooms and Travel
   Objects
   Controlling the Game
 > How the World is Assembled
   If You Get Stuck

   About Interactive Fiction
   What to do with >
   Getting Started
   Rooms and Travel
   Objects
   Controlling the Game
 > How the World is Assembled
   If You Get Stuck

* * *

>[down]
About Interactive Fiction
   What to do with >
   Getting Started
   Rooms and Travel
   Objects
   Controlling the Game
   How the World is Assembled
 > If You Get Stuck

   About Interactive Fiction
   What to do with >
   Getting Started
   Rooms and Travel
   Objects
   Controlling the Game
   How the World is Assembled
 > If You Get Stuck

>[enter]
> Explore
   Read carefully
   Be creative
   Cooperate

>[down]
Explore
 > Read carefully
   Be creative
   Cooperate

   Explore
 > Read carefully
   Be creative
   Cooperate

>[right]
Explore
 > Read carefully
   Be creative
   Cooperate

>[right]
Explore
 > Read carefully
   Be creative
   Cooperate

>[down]
Explore
   Read carefully
 > Be creative
   Cooperate

   Explore
   Read carefully
 > Be creative
   Cooperate

>[down]
Explore
   Read carefully
   Be creative
 > Cooperate

   Explore
   Read carefully
   Be creative
 > Cooperate

>[down]
Explore
   Read carefully
   Be creative
 > Cooperate

   Explore
   Read carefully
   Be creative
 > Cooperate

>[enter]
Play with someone else. Two heads are often better than one. If that doesn't work, try emailing the author or (better yet) posting a request for hints on the newsgroup rec.games.int-fiction.  For best results, put the name of the game you want help with in the subject line; then leave a page or so of blank spoiler space (so that no one will read about where you got to in the game unless they've already played it), and describe your problem as clearly as possible.  Someone will probably be able to tell you how to get around it.

Please press SPACE to continue.

Explore
   Read carefully
   Be creative
 > Cooperate

   Explore
   Read carefully
   Be creative
 > Cooperate

Play with someone else. Two heads are often better than one. If that doesn't work, try emailing the author or (better yet) posting a request for hints on the newsgroup rec.games.int-fiction.  For best results, put the name of the game you want help with in the subject line; then leave a page or so of blank spoiler space (so that no one will read about where you got to in the game unless they've already played it), and describe your problem as clearly as possible.  Someone will probably be able to tell you how to get around it.

Please press SPACE to continue.

Explore
   Read carefully
   Be creative
 > Cooperate

   Explore
   Read carefully
   Be creative
 > Cooperate

>q
About Interactive Fiction
   What to do with >
   Getting Started
   Rooms and Travel
   Objects
   Controlling the Game
   How the World is Assembled
 > If You Get Stuck

>q
Introduction to Retrospect
 > Instructions for Play

>q
Kitchen
You can see some surroundings, a back door, a microwave (in which is a ham sammich), a card, a refrigerator (in which is milk), an oven (in which is an apple pie), a spilled cup, a dark stain and a beer cabinet (empty) here.

>go west
You can't go that way.

>go south
Living Room
You can see a Ketamine, a front door, a couch, a TV and a laptop here.

>go north
Kitchen
You can see a back door, a microwave (in which is a ham sammich), a card, a refrigerator (in which is milk), an oven (in which is an apple pie), a spilled cup, a dark stain and a beer cabinet (empty) here.

>go up
Upstairs

>go east
Master Bedroom
You can see a desk (closed) and a guy here.

>look at desk
A wooden desk with drawers.

>open desk
You open the desk, revealing a cell phone.