Retrospect
An Interactive Fiction by GroopOfFore
Release 1 / Serial number 150403 / Inform 7 build 6L38 (I6/v6.33 lib 6/12N) SD

Front Yard
You can see some bushes and a garden hose here.

>look
Front Yard
You can see some bushes and a garden hose here.

>go north
Living Room

>go east
Garage

>go west
Living Room

>go north
Kitchen

>go upstairs
You can't see any such thing.

>go west
You can't go that way.

>go east
Upstairs

>go east
Master Bedroom

>go west
Upstairs

>go south
Bedrrom

>go north
Upstairs

>go east
Master Bedroom

* * *

>look
Front Yard
You can see some bushes and a garden hose here.

>scenery
That's not a verb I recognise.

>examine driveway
You can't see any such thing.

* * *

>look
Front Yard
You can see some bushes and a garden hose here.

>examine driveway
The driveway looks new but there are dandelions growing in the cracks. You've always hated dandelions. *ah Ah ACHOO* You wipe your nose on a napkin and and put it back in your back pocket.

>examine driveway
The driveway looks new but there are dandelions growing in the cracks. You've always hated dandelions.

* * *

>look
Front Yard
You can see some bushes and a garden hose here.

>examine surroundings
You see an earthy house surrounded by a forest. There are several objects that would ordinarily belong in in a front yard.

>list surroundings
You see a forest, a house, a driveway, a porch, a path, a front door, a lawn, a mail box, and a tree in your surroundings.

>look
Front Yard
You can see some surroundings, some bushes and a garden hose here.

>help
That's not a verb I recognise.

>examine forest
The pine forest stands tall and strong with age. The trees sway lightly in breeze, as if they're friends.

>examine forest
The pine forest stands tall and strong with age.

>examine house
The house is two stories with a shale facade and brushed bronze accents.

>examine drivewat
You can't see any such thing.

>examine driveway
The driveway looks new but there are dandelions growing between the section cracks. You've always hated dandelions. *ah Ah ACHOO* You wipe your nose on a napkin and and put it back in your back pocket.

>examine driveway
The driveway looks new but there are dandelions growing between the section cracks. You've always hated dandelions.

>examine porch
The porch has beautiful hanging flower pots that are budding. The handrail rail is made from black woven metal and brushed bronze.

>examine path
The path connects the front porch to the driveway and passes the bushes. It is made of dark river stones. They crunch softly beneath your feet.

>examine path
The path connects the front porch to the driveway and passes the bushes. It is made of dark river stones.

>examine front door
The front door is black, void of windows, and made of oak. It is unlocked.

>examine front door
The front door is black, void of windows, and made of oak. It is unlocked.

>examine lawn
The lawn is freshly mown and free of debris and weeds.

>examine mail box
The mail box is empty.

>examine tree
The tree looks to be a few years old. It bears fruit, but it's not ripe enough to eat.

>examine apple tree
The tree looks to be a few years old. It bears fruit, but it's not ripe enough to eat.

>examine buches
You can't see any such thing.

>examine bushes
The bushes have beautiful white flowers on them, but they could use some water.

>look
Front Yard
You can see some surroundings, some bushes and a garden hose here.

>examine garden hose
The garden hose has a nozzle attached to it for watering plants.

>turn on garden hose
The nozzle is now turned on.

>turn off garden hose
The nozzle is now turned off.

>water bushes
You have nothing with which to water the plant.

>take nozzle
Taken.

* * *

>examine bushes
The bushes have beautiful white flowers  that glisten in the morning sun.

* * *

>look
Front Yard
You can see some bushes and a garden hose here.

>examien Front Yard
That's not a verb I recognise.

>examine Front Yard
I only understood you as far as wanting to examine the front door.

>sudo update-initramfs
That's not a verb I recognise.

>clear
What do you want to clear?

>laslkd
You can't see any such thing.

I beg your pardon?

I beg your pardon?

>lag?
That's not a verb I recognise.

>kill yourself
You can't see any such thing.

>kill player
You can't see any such thing.

>kill self
Violence isn't the answer to this one.

* * *

Retrospect
An Interactive Fiction by GroopOfFore
Release 1 / Serial number 150403 / Inform 7 build 6L38 (I6/v6.33 lib 6/12N) SD

Front Yard
You can see some bushes and a garden hose here.

>go north
Living Room

>go north
Kitchen

>go west
Upstairs

>go south
Master Bedroom

* * *

>go west
Upstairs

>go west
Master Bedroom

>go east
Upstairs

>go south
Master Bedroom

>go south
You can't go that way.

>go north
Upstairs

>go west
Master Bedroom

>go weast
You can't see any such thing.

>go east
Upstairs

* * *

>go south
Master Bedroom

>go north
Upstairs

>go east
Kitchen

>go north
Back Yard

>go south
Kitchen

* * *

>go west
Upstairs

>look
Upstairs

>go
You'll have to say which compass direction to go in.

>go south
Child's Bedroom

>go north
Upstairs

* * *

>go west
Master Bedroom

>go south
You can't go that way.

* * *

>go north
Kitchen

>go up
Upstairs

>go west
You can't go that way.

>go east
Master Bedroom

* * *

>go west
Upstairs

>go south
Child's Bedroom

* * *

>go north
Upstairs

>go down
Kitchen

>go north
Back Yard

>go north
You can't go that way.

>go south
Kitchen

>quit
Are you sure you want to quit?

>y
[ The game has finished ]

* * *

Retrospect
An Interactive Fiction by GroopOfFore
Release 1 / Serial number 150403 / Inform 7 build 6L38 (I6/v6.33 lib 6/12N) SD

Front Yard
You can see some bushes and a garden hose here.

>water bushes
You have nothing with which to water the plant.

>water
You must supply a noun.

>water bushes
I only understood you as far as wanting to water.

* * *

>water bushes
You have nothing with which to water the plant.

>take nozzle
You can't see any such thing.

>examine garden hose
The garden hose has a nozzle attached to it for watering plants.

>take nozzle
Taken.

* * *

>water bushes
You have nothing with which to water the plant.

>take hose
If anyone needs a shower it's you, not your co-workers.

>examine hose
The garden hose has a nozzle attached to it for watering plants.

>take nozzle
Taken.

>turn on hose
The nozzle is now turned on.

>water co-workers
You can't see any such thing.

* * *

>water plants
You can't see any such thing.

>water plants
You can't see any such thing.

>water bushes
You water the bushes.

>water bush
You can't see any such thing.

>examine bush
You can't see any such thing.

>examine bushes
The bushes have beautiful white flowers that glisten in the morning sun.

>examine surroundings
You see an earthy house surrounded by a forest. There are several objects that would ordinarily belong in in a front yard.

>examine surroundings
You see an earthy house surrounded by a forest. There are several objects that would ordinarily belong in in a front yard.

>list surroundings
You see a forest, a house, a driveway, a porch, a path, a front door, a lawn, a mail box, and an apple tree in your surroundings.

>examine apple tree
The tree looks to be a few years old. It bears fruit, but it's not ripe enough to eat.

>turn on hose
The nozzle is now turned on.

* * *

>take fruit
You can't see any such thing.

>open mail box
It isn't something you can open.

>turn off nozzle
You switch the nozzle off.

* * *

Retrospect
An Interactive Fiction by GroopOfFore
Release 1 / Serial number 150403 / Inform 7 build 6L38 (I6/v6.33 lib 6/12N) SD

Front Yard
You can see some bushes and a garden hose here.

>garden hose is on
That's not a verb I recognise.

* * *

Retrospect
An Interactive Fiction by GroopOfFore
Release 1 / Serial number 150403 / Inform 7 build 6L38 (I6/v6.33 lib 6/12N) SD

Front Yard
You can see some bushes and a garden hose here.

>switch on garden hose
It isn't something you can switch.

* * *

Retrospect
An Interactive Fiction by GroopOfFore
Release 1 / Serial number 150403 / Inform 7 build 6L38 (I6/v6.33 lib 6/12N) SD

Front Yard
You can see some bushes and a garden hose here.

>turn on garden hose
The nozzle is now turned on.

>turn off garden hose
TestThe nozzle is now turned off.

>pick up garden hose
Taken.

>i
You are carrying:
  a garden hose

* * *

>turn on garden hose
The nozzle is now turned on.

>turn off gardn hose
You can't see any such thing.

>turn off garden hose
You switch the garden hose off.

>switch off garden hose
That's already off.

>switch on garden hose
You switch the garden hose on.

* * *

Retrospect
An Interactive Fiction by GroopOfFore
Release 1 / Serial number 150403 / Inform 7 build 6L38 (I6/v6.33 lib 6/12N) SD

Front Yard
You can see some bushes and a garden hose here.

>turn on the garden hose
You switch the garden hose on.

>switch on the garden hose
That's already on.

>take the garden hose
If anyone needs a shower it's you, not your co-workers.

* * *

Retrospect
An Interactive Fiction by GroopOfFore
Release 1 / Serial number 150403 / Inform 7 build 6L38 (I6/v6.33 lib 6/12N) SD

Front Yard
You can see some bushes and a garden hose here.

>examine garden hose
The garden hose has a nozzle attached to it for water plants.

>look
Front Yard
You can see a nozzle, a bushes and a garden hose here.

* * *

Retrospect
An Interactive Fiction by GroopOfFore
Release 1 / Serial number 150403 / Inform 7 build 6L38 (I6/v6.33 lib 6/12N) SD

Front Yard
You can see some bushes and a garden hose here.

>water the row of bushes
You have nothing with which to water the plant.

>examine the garden hose
The garden hose has a nozzle attached to it for water plants.

* * *

Retrospect
An Interactive Fiction by GroopOfFore
Release 1 / Serial number 150403 / Inform 7 build 6L38 (I6/v6.33 lib 6/12N) SD

Front Yard
You can see some bushes and a garden hose here.

>examine the row of bushes
The bushes  have beautiful white flowers on them, but they could use some water.

>water the row of bushes
You have nothing with which to water the plant.

>examine the garden hose
The garden hose has a nozzle attached to it for watering plants.

>turn on the garden hose
The nozzle is now turned on.

>water the row of bushes
You have nothing with which to water the plant.

>take nozzle
Taken.

>water the row of bushes
You water the bushes

* * *

Retrospect
An Interactive Fiction by GroopOfFore
Release 1 / Serial number 150403 / Inform 7 build 6L38 (I6/v6.33 lib 6/12N) SD

Front Yard
You can see some bushes and a garden hose here.

>scenery
That's not a verb I recognise.

>look
Front Yard
You can see some bushes and a garden hose here.

* * *

Retrospect
An Interactive Fiction by GroopOfFore
Release 1 / Serial number 150403 / Inform 7 build 6L38 (I6/v6.33 lib 6/12N) SD

Front Yard
You can see some bushes and a garden hose here.

>examine Front Yard
I only understood you as far as wanting to examine the front door.

>look
Front Yard
You can see some bushes and a garden hose here.

>look
Front Yard
You can see some bushes and a garden hose here.

* * *

>scenery
That's not a verb I recognise.

>look at scener
You can't see any such thing.

>examine scenery
You can't see any such thing.

>look Front Yard
I only understood you as far as wanting to look the front door.

* * *

Retrospect
An Interactive Fiction by GroopOfFore
Release 1 / Serial number 150403 / Inform 7 build 6L38 (I6/v6.33 lib 6/12N) SD

Front Yard
You can see some bushes and a garden hose here.

>examine surroundings
You see an earthy house surrounded by a forest. There are several objects that would ordinarily belong in in a front yard.

>take surroundings
That isn't available.

>go north
Living Room

>examine surroundings
Living Room description

>list surroundings
That isn't available.

>touch surroundings
That isn't available.

* * *

>examine surroundings
You see an earthy house surrounded by a forest. There are several objects that would ordinarily belong in in a front yard.

>i
You are carrying:
  a surroundings

* * *

>examine surroundings
You see an earthy house surrounded by a forest. There are several objects that would ordinarily belong in in a front yard.

>look
Front Yard
You can see some surroundings, some bushes and a garden hose here.

* * *

Retrospect
An Interactive Fiction by GroopOfFore
Release 1 / Serial number 150403 / Inform 7 build 6L38 (I6/v6.33 lib 6/12N) SD

Front Yard
You can see some bushes and a garden hose here.

>examing surroundings
That's not a verb I recognise.

>examine surroundings
surr

* * *

Retrospect
An Interactive Fiction by GroopOfFore
Release 1 / Serial number 150403 / Inform 7 build 6L38 (I6/v6.33 lib 6/12N) SD

Front Yard
You can see some bushes and a garden hose here.

>list surroundings
You can't see any such thing.

>water the surroundings
That isn't available.

>water the bushes
You have nothing with which to water the plant.

* * *

Retrospect
An Interactive Fiction by GroopOfFore
Release 1 / Serial number 150403 / Inform 7 build 6L38 (I6/v6.33 lib 6/12N) SD

Front Yard
You can see some bushes and a garden hose here.

>water surroundings
That isn't available.

>take surroundings
That isn't available.

>examine surroundings
You see an earthy house surrounded by a forest. There are several objects that would ordinarily belong in in a front yard.

>list surroundings
That isn't available.

* * *

Retrospect
An Interactive Fiction by GroopOfFore
Release 1 / Serial number 150403 / Inform 7 build 6L38 (I6/v6.33 lib 6/12N) SD

Front Yard
You can see some bushes and a garden hose here.

>water the surroundings
That isn't available.

>take the surroundings
That isn't available.

* * *

Retrospect
An Interactive Fiction by GroopOfFore
Release 1 / Serial number 150403 / Inform 7 build 6L38 (I6/v6.33 lib 6/12N) SD

Front Yard
You can see some bushes and a garden hose here.

>examine
What do you want to examine?

>examine surroundings
You see an earthy house surrounded by a forest. There are several objects that would ordinarily belong in in a front yard.

* * *

Retrospect
An Interactive Fiction by GroopOfFore
Release 1 / Serial number 150403 / Inform 7 build 6L38 (I6/v6.33 lib 6/12N) SD

Front Yard
You can see some bushes and a garden hose here.

>examine bushes
The bushes have beautiful white flowers on them, but they could use some water.

>water bushes
You have nothing with which to water the plant.

>examine bushes
The bushes have beautiful white flowers on them, but they could use some water.

* * *

Retrospect
An Interactive Fiction by GroopOfFore
Release 1 / Serial number 150403 / Inform 7 build 6L38 (I6/v6.33 lib 6/12N) SD

Front Yard
You can see some bushes and a garden hose here.

>water the bushes
You have nothing with which to water the plant.

>examine garden hose
The garden hose has a nozzle attached to it for watering plants.

* * *

>take nozzle
Taken.

>water the bushes
You can't water the bushes when the nozzle is off.

>turn on garden hose
The nozzle is now turned on.

>water bushes
You water the bushes.

>examien bushes
That's not a verb I recognise.

>examine\\ bushes
That's not a verb I recognise.

* * *

>water the bushes
You have nothing with which to water the plant.

>examine bushes
The bushes have beautiful white flowers on them, but they could use some water.

>examine garden hose
The garden hose has a nozzle attached to it for watering plants.

* * *

>water the bushes
You can't water the bushes when the nozzle is off.

>examine garden hose
The garden hose has a nozzle attached to it for watering plants.

>examine bushes
The bushes have beautiful white flowers on them, but they could use some water.

>turn on garden hose
The nozzle is now turned on.

>water the bushes
You water the bushes.

>examine bushes
The bushes have beautiful white flowers  that glisten in the morning sun.

* * *

Retrospect
An Interactive Fiction by GroopOfFore
Release 1 / Serial number 150403 / Inform 7 build 6L38 (I6/v6.33 lib 6/12N) SD

Front Yard
You can see some bushes and a garden hose here.

>help
 > Introduction to Retrospect
   Instructions for Play

 > Introduction to Retrospect
   Instructions for Play

 > Introduction to Retrospect
   Instructions for Play

   Introduction to Retrospect
 > Instructions for Play
   Introduction to Retrospect
 > Instructions for Play

 > Introduction to Retrospect
   Instructions for Play
 > Introduction to Retrospect
   Instructions for Play

   Introduction to Retrospect
 > Instructions for Play
   Introduction to Retrospect
 > Instructions for Play

 > About Interactive Fiction
   What to do with >
   Getting Started
   Rooms and Travel
   Objects
   Controlling the Game
   How the World is Assembled
   If You Get Stuck

   About Interactive Fiction
 > What to do with >
   Getting Started
   Rooms and Travel
   Objects
   Controlling the Game
   How the World is Assembled
   If You Get Stuck
   About Interactive Fiction
 > What to do with >
   Getting Started
   Rooms and Travel
   Objects
   Controlling the Game
   How the World is Assembled
   If You Get Stuck

   About Interactive Fiction
   What to do with >
 > Getting Started
   Rooms and Travel
   Objects
   Controlling the Game
   How the World is Assembled
   If You Get Stuck
   About Interactive Fiction
   What to do with >
 > Getting Started
   Rooms and Travel
   Objects
   Controlling the Game
   How the World is Assembled
   If You Get Stuck

   About Interactive Fiction
   What to do with >
   Getting Started
 > Rooms and Travel
   Objects
   Controlling the Game
   How the World is Assembled
   If You Get Stuck
   About Interactive Fiction
   What to do with >
   Getting Started
 > Rooms and Travel
   Objects
   Controlling the Game
   How the World is Assembled
   If You Get Stuck

   About Interactive Fiction
   What to do with >
   Getting Started
   Rooms and Travel
 > Objects
   Controlling the Game
   How the World is Assembled
   If You Get Stuck
   About Interactive Fiction
   What to do with >
   Getting Started
   Rooms and Travel
 > Objects
   Controlling the Game
   How the World is Assembled
   If You Get Stuck

   About Interactive Fiction
   What to do with >
   Getting Started
   Rooms and Travel
   Objects
 > Controlling the Game
   How the World is Assembled
   If You Get Stuck
   About Interactive Fiction
   What to do with >
   Getting Started
   Rooms and Travel
   Objects
 > Controlling the Game
   How the World is Assembled
   If You Get Stuck

   About Interactive Fiction
   What to do with >
   Getting Started
   Rooms and Travel
   Objects
   Controlling the Game
 > How the World is Assembled
   If You Get Stuck
   About Interactive Fiction
   What to do with >
   Getting Started
   Rooms and Travel
   Objects
   Controlling the Game
 > How the World is Assembled
   If You Get Stuck

   About Interactive Fiction
   What to do with >
   Getting Started
   Rooms and Travel
   Objects
 > Controlling the Game
   How the World is Assembled
   If You Get Stuck
   About Interactive Fiction
   What to do with >
   Getting Started
   Rooms and Travel
   Objects
 > Controlling the Game
   How the World is Assembled
   If You Get Stuck

   About Interactive Fiction
   What to do with >
   Getting Started
   Rooms and Travel
 > Objects
   Controlling the Game
   How the World is Assembled
   If You Get Stuck
   About Interactive Fiction
   What to do with >
   Getting Started
   Rooms and Travel
 > Objects
   Controlling the Game
   How the World is Assembled
   If You Get Stuck

* * *

   About Interactive Fiction
   What to do with >
   Getting Started
   Rooms and Travel
   Objects
   Controlling the Game
 > How the World is Assembled
   If You Get Stuck
   About Interactive Fiction
   What to do with >
   Getting Started
   Rooms and Travel
   Objects
   Controlling the Game
 > How the World is Assembled
   If You Get Stuck

   About Interactive Fiction
   What to do with >
   Getting Started
   Rooms and Travel
   Objects
   Controlling the Game
   How the World is Assembled
 > If You Get Stuck
   About Interactive Fiction
   What to do with >
   Getting Started
   Rooms and Travel
   Objects
   Controlling the Game
   How the World is Assembled
 > If You Get Stuck

 > Explore
   Read carefully
   Be creative
   Cooperate

   Explore
 > Read carefully
   Be creative
   Cooperate
   Explore
 > Read carefully
   Be creative
   Cooperate

   Explore
   Read carefully
 > Be creative
   Cooperate
   Explore
   Read carefully
 > Be creative
   Cooperate

   Explore
   Read carefully
   Be creative
 > Cooperate
   Explore
   Read carefully
   Be creative
 > Cooperate

   Explore
   Read carefully
 > Be creative
   Cooperate
   Explore
   Read carefully
 > Be creative
   Cooperate

   Explore
 > Read carefully
   Be creative
   Cooperate
   Explore
 > Read carefully
   Be creative
   Cooperate

>q
   About Interactive Fiction
   What to do with >
   Getting Started
   Rooms and Travel
   Objects
   Controlling the Game
   How the World is Assembled
 > If You Get Stuck

>q
   Introduction to Retrospect
 > Instructions for Play

>q
Front Yard
You can see some bushes and a garden hose here.

* * *

Retrospect
An Interactive Fiction by GroopOfFore
Release 1 / Serial number 150403 / Inform 7 build 6L38 (I6/v6.33 lib 6/12N) SD

Front Yard
You can see some bushes and a garden hose here.

>examine hose
The garden hose has a nozzle attached to it for watering plants.

* * *

>take nozzle
Taken.

>siwtch on nozzle
That's not a verb I recognise.

>turn on nozzle
The hose controls the nozzle.

>water bushes
You can't water the bushes when the nozzle is off.

>turn on hose
The nozzle is now turned on.

>water bushes
You water the bushes.

>examine bushes
The bushes have beautiful white flowers that glisten in the morning sun.

>clear
(the nozzle)
Nothing obvious happens.

>cls
That's not a verb I recognise.

>help
 > Introduction to Retrospect
   Instructions for Play

   Introduction to Retrospect
 > Instructions for Play
   Introduction to Retrospect
 > Instructions for Play

* * *

   About Interactive Fiction
   What to do with >
   Getting Started
   Rooms and Travel
 > Objects
   Controlling the Game
   How the World is Assembled
   If You Get Stuck
   About Interactive Fiction
   What to do with >
   Getting Started
   Rooms and Travel
 > Objects
   Controlling the Game
   How the World is Assembled
   If You Get Stuck

   About Interactive Fiction
   What to do with >
   Getting Started
 > Rooms and Travel
   Objects
   Controlling the Game
   How the World is Assembled
   If You Get Stuck
   About Interactive Fiction
   What to do with >
   Getting Started
 > Rooms and Travel
   Objects
   Controlling the Game
   How the World is Assembled
   If You Get Stuck

At any given time, you are in a specific location, or room. When you go into a room, the game will print a description of what you can see there. This description will contain two vital kinds of information: things in the room you can interact with or take, and a list of exits, or ways out. If you want to see the description again, you may just type LOOK. 

When you want to leave a location and go to another one, you may communicate this to the game using compass directions: eg, GO NORTH. For simplicity's sake, you are allowed to omit the word GO, and to abbreviate the compass directions. So you may use NORTH, SOUTH, EAST, WEST, NORTHEAST, SOUTHEAST, NORTHWEST, SOUTHWEST, UP, and DOWN, or in short form N, S, E, W, NE, SE, NW, SW, U, and D.

In some locations, IN and OUT will also be useful.

Please press SPACE to continue.

   About Interactive Fiction
   What to do with >
   Getting Started
 > Rooms and Travel
   Objects
   Controlling the Game
   How the World is Assembled
   If You Get Stuck
   About Interactive Fiction
   What to do with >
   Getting Started
 > Rooms and Travel
   Objects
   Controlling the Game
   How the World is Assembled
   If You Get Stuck

* * *

   About Interactive Fiction
   What to do with >
   Getting Started
   Rooms and Travel
 > Objects
   Controlling the Game
   How the World is Assembled
   If You Get Stuck
   About Interactive Fiction
   What to do with >
   Getting Started
   Rooms and Travel
 > Objects
   Controlling the Game
   How the World is Assembled
   If You Get Stuck

Throughout the game there will be assorted objects that you can do things with. Most importantly, you may TAKE or GET items, and (when you are tired of them) DROP them again. INVENTORY (abbreviated I) will list the items you are currently holding. 

There are usually assorted things you may do with these objects. OPEN, CLOSE, WEAR, EAT, LOCK, and UNLOCK are especially common.

Occasionally, you will find that the game does not recognize the name of an object even though it has been described as being in the room with you. If this is the case, the object is just there for scenery, and you may assume that you do not need to interact with it.

Please press SPACE to continue.

   About Interactive Fiction
   What to do with >
   Getting Started
   Rooms and Travel
 > Objects
   Controlling the Game
   How the World is Assembled
   If You Get Stuck
   About Interactive Fiction
   What to do with >
   Getting Started
   Rooms and Travel
 > Objects
   Controlling the Game
   How the World is Assembled
   If You Get Stuck

* * *

   About Interactive Fiction
   What to do with >
   Getting Started
   Rooms and Travel
   Objects
 > Controlling the Game
   How the World is Assembled
   If You Get Stuck
   About Interactive Fiction
   What to do with >
   Getting Started
   Rooms and Travel
   Objects
 > Controlling the Game
   How the World is Assembled
   If You Get Stuck

There are a few simple commands for controlling the game itself. These are: 

SAVE saves a snapshot of the game as it is now. 
RESTORE puts the game back to a previous saved state. You may keep as many saved games as you like. 
RESTART puts the game back to the way it was at the beginning. 
QUIT ends the game.

Please press SPACE to continue.

   About Interactive Fiction
   What to do with >
   Getting Started
   Rooms and Travel
   Objects
 > Controlling the Game
   How the World is Assembled
   If You Get Stuck
   About Interactive Fiction
   What to do with >
   Getting Started
   Rooms and Travel
   Objects
 > Controlling the Game
   How the World is Assembled
   If You Get Stuck

* * *

   About Interactive Fiction
   What to do with >
   Getting Started
   Rooms and Travel
   Objects
   Controlling the Game
   How the World is Assembled
 > If You Get Stuck
   About Interactive Fiction
   What to do with >
   Getting Started
   Rooms and Travel
   Objects
   Controlling the Game
   How the World is Assembled
 > If You Get Stuck

   About Interactive Fiction
   What to do with >
   Getting Started
   Rooms and Travel
   Objects
   Controlling the Game
 > How the World is Assembled
   If You Get Stuck
   About Interactive Fiction
   What to do with >
   Getting Started
   Rooms and Travel
   Objects
   Controlling the Game
 > How the World is Assembled
   If You Get Stuck

 > Space
   Containment
   Types of Action
   Other Characters

   Space
 > Containment
   Types of Action
   Other Characters
   Space
 > Containment
   Types of Action
   Other Characters

 > Space
   Containment
   Types of Action
   Other Characters
 > Space
   Containment
   Types of Action
   Other Characters

Most IF games are set in a world made up of rooms without internal division. Movement between rooms is possible; movement within a room does not always amount to anything. >WALK OVER TO THE DESK is rarely a useful sort of command. On the other hand, if something is described as being high or out of reach, it is sometimes relevant to stand on an object to increase your height. This kind of activity tends to be important only if prompted by the game text.

Please press SPACE to continue.

* * *

 > Space
   Containment
   Types of Action
   Other Characters
 > Space
   Containment
   Types of Action
   Other Characters

>q
   About Interactive Fiction
   What to do with >
   Getting Started
   Rooms and Travel
   Objects
   Controlling the Game
 > How the World is Assembled
   If You Get Stuck

>q
   Introduction to Retrospect
 > Instructions for Play

>q
Front Yard
You can see some surroundings, some bushes and a garden hose here.

>go east
You can't go that way.

>go west
You can't go that way.

>go north
Living Room

>look
Living Room

>kill self
Violence isn't the answer to this one.

I beg your pardon?

>no
That was a rhetorical question.

>pet the cow
That's not a verb I recognise.

>walk the dinosaur
You can't see any such thing.

>open door
You can't see any such thing.

>mfw
That's not a verb I recognise.